19,19 19,9 7,2 13,2 7,7 13,7 7,11 13,11 5,15 15,15
111111111111111111111111111111111111111
100000000000000000000000000000000000001
100000000000000000000000000000000000001
111111111111111000000001111111111111111
100000000000000001111000000000000000001
100000000000000000000000000000000000001
100000000000111111111111110000000000001
100000000000000000000000000000000000001
100011111111000000000000000111111110001
100000000000000000000000000000000000001
110000000000000001111100000000000000011
100000000000000000000000000000000000001
100011111111100000000000001111111110001
100000000000000000000000000000000000001
110000000000011111111111110000000000011
100000000000000000000000000000000000001
111111111110000000000000000011111111111
100000000000000000000000000000000000001
100011111111111100000001111111111110001
100000000000000000000000000000000000001
200000000000001111111111100000000000002
111111111111111111111111111111111111111