111111111111111111111111111111111111111
100000000000000000000000000000000000001
111111111111111000000001111111111111111
100000000000000000000000000000000000001
100000000000000001111000000000000000001
100000000000000000000000000000000000001
100011111111111111111111111111100000001
100000000000000000000000000000000000001
111111111110000000001111111111111111111
100000000000000000000000000000000000001
100000111111111111111110000000000000001
100000000000000000000000000000000000001
111111000000000000000000111111111000001
100000000000000000000000000000000000001
111111111111111111111111000000000000001
100000000000000000000000000000000000001
111100011110001111000111100011110011111
100000000000000000000000000000000000001
101111111111111100000001111111111111101
100000000000000000000000000000000000001
200000000000001111111111100000000000002
111111111111111111111111111111111111111
