1111111111111111111111111111111111111111
1000000000000000000000000000000000000001
1000000000000000000000000000000000000001
1000000000000000000000000000000000000001
1000011111111100000000000000000000000001
1000000000000000000000000000000000000001
1000000000000000000000011111100000000001
1000000000000000000000000000000000000001
1000001111000000000000000000000000000001
1000000000000000000000000000000000000001
1000000000000011111111111111000000000001
1000000000000000000000000000000000000001
1000001110000000000011100000000000000001
1000000000000000000000000000000000000001
1000000000000001111111000000000000000001
1000000000000000000000000000000000000001
1000011111110000000000000000000000000001
1000000000000000000000000000000000000001
1000000110000000000000000000000000000001
1000000000000000000000000000000000000001
1111111111111111111111111111111111111111
1111111111111111111111111111111111111111
