1111111111111111111111111111111111111111
1000000000000000000000000000000000000001
1000000000000000000000000000000000000001
1000000011110000000000000000000000000001
1000000000000000000000000000000000000001
1000000000110000000000000000000000000001
1000000000111111111111000000000000000001
1000000000000000000000000000000000000001
1000000001110000000000000000000000000001
1000000000000000000000000000000000000001
1000000011111100000000000000000000000001
1000000000000000000000000000000000000001
1000000000000001111111110000000000000001
1000000000000000000000000000000000000001
1000000000011111111111111111100000000001
1000000000000000000000000000000000000001
1000000000000000000011000000000000000001
1000000000000000000000000000000000000001
1000000011110000000000001111000000000001
1000000000000000000000000000000000000001
1111111111111111111111111111111111111111
1111111111111111111111111111111111111111
